##########################################
##....#..................#........#....@##
##.............#..................#.....##
##...@.#...#........#.........#........###
##..#..#.......##......#..#.......##....##
##......................................##
###.....#..#..#...#..#........#..#...#..##
##....#.................................##
##.............#..................#.....##
##...@.....#........#.........#.......####
##..####.......##......####.......##....##
##...................................#.@##
##########################################