#######################
##...................##
##...................##
##.........#........###
##..####.......##....##
##...................##
#######################