#######################
##....#..............##
##.............#.....##
##...@.....#........###
##..####.......##....##
##...................##
#######################