##########################################
##....#..................#..............##
##.............#..................#.....##
##...@.....#........#...@.....#........###
##..####.......##......####.......##....##
##......................................##
###...#########...####...#########...#####
##....#..................#..............##
##.............#..................#.....##
##...@.....#........#...@.....#........###
##..####.......##......####.......##....##
##......................................##
##########################################