##########################################
##....#..................#(............@##
##.............#......................#.##
##...@.#...#........#.........#...#....###
##..####.......##......#..#.......##.#..##
##(.....................................##
###.....#.....#...#...........#..#......##
##....#.................................##
##.............#.........@........#.....##
##.........#........#.........#.......####
##.....#.......##......####.......##....##
##.........#.........................#.@##
##########################################