##########################################
##....#..................#..............##
##.............#..................#.....##
##...@.....#........#...@.....#........###
##..####.......##......####.......##....##
##(.....................................##
###...#########...####...#########...#####
##....#.................)(..............##
##.............#..................#.....##
##...@.....#........#...@.....#........###
##..####.......##......####.......##....##
##......................................##
##########################################