@@@@@@@@@@@@@@@@@@@
...................
...................
.........#........#
..####.......##....
...................
###################