#######################
##....#..............##
##.............#.....##
##.........#........###
##..####.......##....##
##...................##
#######################