@@@@@@@@@@@@@@@@@@@@@@@@@@@@@@@@@@@@@@@@
........................................
........................................
.........#........#.....................
..####.......##.......####.......##.....
........................................
########################################